EA ./textures/Keffiyeh.xpm
NO ./textures/aboobayda.xpm
SO ./textures/aboobayda.xpm
WE ./textures/Keffiyeh.xpm

F 50,50,50
C 50,50,50

11111111111111111111111111111
10000000001100000000000000001
10110000011100000100000010001
10010000000000000D00000010001
10110000011100000100000010001
10000000001100000011011110001
11110111111111011100000010001
1111D111111111011101D10010001
11000000110101011100000010001
10000000000000001100000010001
10000000000000001100010000001
11000000110101000000000000001
1111D111110101000000000000001
100000000011000001001D1001001
10000000000000000000000001001
10000000001000010000N00001001
10000000001101000000000000001
10000000000100000001010000001
11111111111111111111111111111