EA ./textures/Keffiyeh.xpm
NO ./textures/flag1.xpm
SO ./textures/flag1.xpm
WE ./textures/Keffiyeh.xpm

C 255,255,255
F 255,255,255

111111111111111111111111
10000000000S000000000001
100000111000000111000001
100000111000000111000001
100000111000000111000001
100000111000000111000001
100000111000000111000001
100000111000000111000001
100000111000000111000001
100000111000000111000001
100000111000000111000001
100000111000000111000001
100000111000000111000001
100000111000000111000001
100000111000000111000001
100000111000000111000001
100000111000000111000001
10000011100N000111000001
100000111000000111000001
100000111000000111000001
100000111000000111000001
100000111000000111000001
100000111000000111000001
111111111111111111111111